1111111111
1000000001
1011101101
101E101001
1010101011
1010101001
10101C1101
1010111001
1010000011
1011111111
101C100P01
1010100001
1010111101
1000000001
1111111111