1111111
10000C1
1111111
1P000E1
1111111
