1111111
10000E1
1111111
1P000C1
1111111
